17 35
1 1 1 1 1 1 1 1 1 1 1 1 1 1 1 1 1 1 1 1 1 1 1 1 1 1 1 1 1 1 1 1 1 1 1
1 2 3 3 2 2 1 2 1 2 1 2 2 2 2 2 2 2 1 2 1 2 2 2 2 2 2 2 2 2 2 2 2 2 1
1 2 1 1 1 2 1 2 1 2 1 2 2 2 2 1 2 2 2 2 1 2 1 2 1 2 1 2 1 1 1 1 1 2 1
1 2 1 2 1 2 2 2 1 2 2 2 1 2 2 1 2 2 1 2 2 2 1 2 1 2 1 2 2 2 2 2 2 2 1
1 2 1 2 1 2 1 1 1 1 1 2 1 1 1 1 1 1 1 1 1 2 1 2 1 1 1 1 1 1 1 1 1 2 1
1 2 1 2 2 2 2 2 1 2 2 2 1 2 2 2 2 2 2 2 1 2 1 2 2 2 2 2 2 2 2 2 2 2 1
1 2 1 1 1 2 1 1 1 1 1 2 1 2 2 1 2 2 1 1 1 2 1 2 1 1 1 1 1 1 2 2 1 1 1
1 2 2 2 2 2 1 2 2 2 1 2 1 2 2 1 2 2 1 2 2 2 2 2 2 2 1 2 2 1 2 2 2 2 1
1 2 1 1 1 2 1 1 1 2 1 2 1 1 1 1 2 2 1 1 1 1 1 2 1 1 1 2 2 1 1 1 1 2 1
1 2 1 2 1 2 2 2 2 2 1 2 1 2 2 1 2 2 1 3 1 2 2 2 2 2 2 2 2 2 2 2 2 2 1
1 2 1 2 1 1 1 2 1 2 1 0 1 2 2 1 2 2 1 2 1 1 1 2 1 1 1 2 2 1 2 2 1 2 1
1 2 2 2 2 2 1 2 1 2 1 2 1 2 2 2 2 2 2 2 2 2 1 2 2 2 1 2 2 2 2 2 1 2 1
1 1 1 2 1 2 1 1 1 2 1 2 1 1 1 1 1 1 1 1 1 2 1 2 1 1 1 2 2 1 2 2 1 2 1
1 2 1 2 1 2 2 2 1 2 1 2 2 2 2 2 3 2 1 2 2 2 1 2 1 2 2 2 2 1 2 2 2 2 1
1 2 1 1 1 2 1 1 1 2 1 1 1 1 2 1 1 1 1 2 1 2 1 2 1 1 2 1 1 1 1 1 1 2 1
1 2 2 2 2 2 2 2 1 2 2 2 2 2 2 2 2 2 2 2 1 2 1 2 2 2 2 2 2 2 2 2 2 2 1
1 1 1 1 1 1 1 1 1 1 1 1 1 1 1 1 1 1 1 1 1 1 1 1 1 1 1 1 1 1 1 1 1 1 1
10 11